EA ./textures/Chocoeastsquare.xpm
NO ./textures/Choconorthsquare.xpm
SO ./textures/Chocosouth.xpm
F 88,41,0
C 225,198,153

WE ./textures/Chocowest.xpm

1111111111111111111111111111
1010101010100000000000011001
11100000000S0000000000001111
1111111000000000000000001111
1111100001000000011000011111 
111111111111111111111111111
